,ANIO,PROVINCIA,Hidroelectrica,Termica,Eolica,Fotovoltaica,Nuclear,Total
0,1990,ALMERIA,368,655000,0,0,0,655368
1,1990,CADIZ,15680,2967720,0,0,0,2983400
2,1990,CORDOBA,111160,665026,0,0,0,776186
3,1990,GRANADA,167188,18288,0,0,0,185476
4,1990,HUELVA,0,886830,0,0,0,886830
5,1990,JAEN,356876,42320,0,0,0,399196
6,1990,MALAGA,963558,237520,0,0,0,1201078
7,1990,SEVILLA,542840,18030,0,0,0,560870
8,1990,HUESCA,2137888,0,0,0,0,2137888
9,1990,TERUEL,50736,2453372,0,0,0,2504108
10,1990,ZARAGOZA,752054,270226,0,0,0,1022280
11,1990,ASTURIAS,1391864,5439550,0,0,0,6831414
12,1990,BALEARES,0,735290,0,0,0,735290
13,1990,LAS PALMAS,0,1373400,0,0,0,1373400
14,1990,S.C.TENERIFE,1600,948874,0,0,0,950474
15,1990,CANTABRIA,845952,206488,0,0,0,1052440
16,1990,AVILA,69028,0,0,0,0,69028
17,1990,BURGOS,30899,19760,0,0,460000,510659
18,1990,LEON,633174,4593500,0,0,0,5226674
19,1990,PALENCIA,138534,1013650,0,0,0,1152184
20,1990,SALAMANCA,5094180,18200,0,0,0,5112380
21,1990,SEGOVIA,16706,0,0,0,0,16706
22,1990,SORIA,25196,0,0,0,0,25196
23,1990,VALLADOLID,15270,60216,0,0,0,75486
24,1990,ZAMORA,1372320,33600,0,0,0,1405920
25,1990,ALBACETE,38441,0,0,0,0,38441
26,1990,CIUDAD REAL,5292,548000,0,0,0,553292
27,1990,CUENCA,292512,0,0,0,0,292512
28,1990,GUADALAJARA,591808,0,0,0,2402000,2993808
29,1990,TOLEDO,526402,1254208,0,0,0,1780610
30,1990,BARCELONA,95534,2748705,0,0,0,2844239
31,1990,GIRONA,271302,30290,0,0,0,301592
32,1990,LLEIDA,3320102,16000,0,0,0,3336102
33,1990,TARRAGONA,610600,48400,0,0,5684000,6343000
34,1990,CEUTA,0,54240,0,0,0,54240
35,1990,BADAJOZ,158996,3000,0,0,0,161996
36,1990,CACERES,3938466,80,0,0,3722400,7660946
37,1990,LA CORUÑA,582500,4926300,0,0,0,5508800
38,1990,LUGO,945972,0,0,0,0,945972
39,1990,ORENSE,3595296,0,0,0,0,3595296
40,1990,PONTEVEDRA,164276,27782,0,0,0,192058
41,1990,LA RIOJA,59780,0,0,0,0,59780
42,1990,MADRID,138124,5280,0,0,0,143404
43,1990,MELILLA,0,44752,0,0,0,44752
44,1990,MURCIA,75348,1748290,0,0,0,1823638
45,1990,NAVARRA,184506,35860,0,0,0,220366
46,1990,ALAVA,33555,14300,0,0,0,47855
47,1990,GUIPUZCOA,37994,482148,0,0,0,520142
48,1990,VIZCAYA,176774,2054026,0,0,0,2230800
49,1990,ALICANTE,680,0,0,0,0,680
50,1990,CASTELLON,97784,2178692,0,0,0,2276476
51,1990,VALENCIA,2401728,7680,0,0,1987552,4396960
52,1991,ALMERIA,0,655000,0,0,0,655000
53,1991,CADIZ,9280,2967720,0,0,0,2977000
54,1991,CORDOBA,111160,665026,0,0,0,776186
55,1991,GRANADA,153680,18288,0,0,0,171968
56,1991,HUELVA,0,1079260,0,0,0,1079260
57,1991,JAEN,345204,42320,0,0,0,387524
58,1991,MALAGA,963078,237520,0,0,0,1200598
59,1991,SEVILLA,540736,18030,0,0,0,558766
60,1991,HUESCA,2138192,0,0,0,0,2138192
61,1991,TERUEL,47424,2466000,0,0,0,2513424
62,1991,ZARAGOZA,752722,288906,0,0,0,1041628
63,1991,ASTURIAS,1391348,5438950,0,0,0,6830298
64,1991,BALEARES,0,780090,0,0,0,780090
65,1991,LAS PALMAS,0,1368360,0,0,0,1368360
66,1991,S.C.TENERIFE,1600,1008474,0,0,0,1010074
67,1991,CANTABRIA,845840,206488,0,0,0,1052328
68,1991,AVILA,68588,0,0,0,0,68588
69,1991,BURGOS,30191,24340,0,0,460000,514531
70,1991,LEON,718094,4593500,0,0,0,5311594
71,1991,PALENCIA,138224,1020650,0,0,0,1158874
72,1991,SALAMANCA,5092778,18200,0,0,0,5110978
73,1991,SEGOVIA,16706,0,0,0,0,16706
74,1991,SORIA,24596,0,0,0,0,24596
75,1991,VALLADOLID,16112,78316,0,0,0,94428
76,1991,ZAMORA,1372320,33600,0,0,0,1405920
77,1991,ALBACETE,38441,0,0,0,0,38441
78,1991,CIUDAD REAL,5292,548000,0,0,0,553292
79,1991,CUENCA,292462,0,0,0,0,292462
80,1991,GUADALAJARA,591856,0,0,0,2402000,2993856
81,1991,TOLEDO,526402,1254208,0,0,0,1780610
82,1991,BARCELONA,95237,2820044,0,0,0,2915281
83,1991,GIRONA,266386,50290,0,0,0,316676
84,1991,LLEIDA,3228862,16000,0,0,0,3244862
85,1991,TARRAGONA,610600,94920,0,0,5684000,6389520
86,1991,CEUTA,0,54240,0,0,0,54240
87,1991,BADAJOZ,158556,3000,0,0,0,161556
88,1991,CACERES,3938466,0,0,0,3722400,7660866
89,1991,LA CORUÑA,582450,4919360,0,0,0,5501810
90,1991,LUGO,945972,0,0,0,0,945972
91,1991,ORENSE,3593088,0,0,0,0,3593088
92,1991,PONTEVEDRA,164696,28532,0,0,0,193228
93,1991,LA RIOJA,59780,0,0,0,0,59780
94,1991,MADRID,137534,18444,0,0,0,155978
95,1991,MELILLA,0,74040,0,0,0,74040
96,1991,MURCIA,75348,1752290,0,0,0,1827638
97,1991,NAVARRA,216512,50246,0,0,0,266758
98,1991,ALAVA,33555,14280,0,0,0,47835
99,1991,GUIPUZCOA,38940,482148,0,0,0,521088
100,1991,VIZCAYA,176766,2078594,0,0,0,2255360
101,1991,ALICANTE,680,0,0,0,0,680
102,1991,CASTELLON,97784,2216184,0,0,0,2313968
103,1991,VALENCIA,2400604,27716,0,0,1987552,4415872
104,1992,ALMERIA,368,655000,0,0,0,655368
105,1992,CADIZ,15680,2967720,1180,0,0,2984580
106,1992,CORDOBA,111160,665026,0,0,0,776186
107,1992,GRANADA,167188,18288,0,0,0,185476
108,1992,HUELVA,0,1079260,0,0,0,1079260
109,1992,JAEN,356876,42320,0,0,0,399196
110,1992,MALAGA,963558,237520,0,0,0,1201078
111,1992,SEVILLA,542840,18030,0,0,0,560870
112,1992,HUESCA,2141616,0,0,0,0,2141616
113,1992,TERUEL,53056,2450000,0,0,0,2503056
114,1992,ZARAGOZA,752722,288906,0,0,0,1041628
115,1992,ASTURIAS,1392214,5438950,0,0,0,6831164
116,1992,BALEARES,0,780690,0,0,0,780690
117,1992,LAS PALMAS,0,1466360,0,0,0,1466360
118,1992,S.C.TENERIFE,1600,1008474,0,0,0,1010074
119,1992,CANTABRIA,846352,206488,0,0,0,1052840
120,1992,AVILA,69028,0,0,0,0,69028
121,1992,BURGOS,30899,24605,0,0,460000,515504
122,1992,LEON,775574,4608900,0,0,0,5384474
123,1992,PALENCIA,138534,1020650,0,0,0,1159184
124,1992,SALAMANCA,5094170,18200,0,0,0,5112370
125,1992,SEGOVIA,16706,0,0,0,0,16706
126,1992,SORIA,25196,0,0,0,0,25196
127,1992,VALLADOLID,18230,79316,0,0,0,97546
128,1992,ZAMORA,1372320,33600,0,0,0,1405920
129,1992,ALBACETE,38441,0,0,0,0,38441
130,1992,CIUDAD REAL,5292,618000,0,0,0,623292
131,1992,CUENCA,293932,0,0,0,0,293932
132,1992,GUADALAJARA,592312,0,0,0,2452000,3044312
133,1992,TOLEDO,527042,1254208,0,0,0,1781250
134,1992,BARCELONA,96409,2794560,0,0,0,2890969
135,1992,GIRONA,279340,50290,1180,0,0,330810
136,1992,LLEIDA,3239870,16000,0,0,0,3255870
137,1992,TARRAGONA,610600,92458,0,0,5728000,6431058
138,1992,CEUTA,0,54240,0,0,0,54240
139,1992,BADAJOZ,184056,3000,0,0,0,187056
140,1992,CACERES,3938466,80,0,0,3722400,7660946
141,1992,LA CORUÑA,591262,4922026,0,0,0,5513288
142,1992,LUGO,945972,0,0,0,0,945972
143,1992,ORENSE,3595296,0,0,0,0,3595296
144,1992,PONTEVEDRA,175896,59750,0,0,0,235646
145,1992,LA RIOJA,59860,0,0,0,0,59860
146,1992,MADRID,138124,18280,0,0,0,156404
147,1992,MELILLA,0,74040,0,0,0,74040
148,1992,MURCIA,75528,1752290,0,0,0,1827818
149,1992,NAVARRA,240864,50504,0,0,0,291368
150,1992,ALAVA,33555,17800,0,0,0,51355
151,1992,GUIPUZCOA,43868,493348,0,0,0,537216
152,1992,VIZCAYA,176966,2078524,0,0,0,2255490
153,1992,ALICANTE,680,0,0,0,0,680
154,1992,CASTELLON,97784,2221354,0,0,0,2319138
155,1992,VALENCIA,2402528,27170,0,0,1987552,4417250
156,1993,ALMERIA,368,655000,0,0,0,655368
157,1993,CADIZ,15680,2967720,880,0,0,2984280
158,1993,CORDOBA,111160,661276,0,0,0,772436
159,1993,GRANADA,167188,18288,0,0,0,185476
160,1993,HUELVA,0,1040110,0,0,0,1040110
161,1993,JAEN,356876,42320,0,0,0,399196
162,1993,MALAGA,963558,237520,0,0,0,1201078
163,1993,SEVILLA,542840,18030,0,0,0,560870
164,1993,HUESCA,2141616,0,0,0,0,2141616
165,1993,TERUEL,53056,2450000,0,0,0,2503056
166,1993,ZARAGOZA,752722,408156,0,0,0,1160878
167,1993,ASTURIAS,1390786,5438950,0,0,0,6829736
168,1993,BALEARES,0,841190,0,0,0,841190
169,1993,LAS PALMAS,0,1466360,360,0,0,1466720
170,1993,S.C.TENERIFE,1600,1008474,600,0,0,1010674
171,1993,CANTABRIA,835600,198488,0,0,0,1034088
172,1993,AVILA,69028,0,0,0,0,69028
173,1993,BURGOS,30874,32605,0,0,460000,523479
174,1993,LEON,779356,4608900,0,0,0,5388256
175,1993,PALENCIA,137784,1020650,0,0,0,1158434
176,1993,SALAMANCA,5094170,18200,0,0,0,5112370
177,1993,SEGOVIA,16706,0,0,0,0,16706
178,1993,SORIA,26796,0,0,0,0,26796
179,1993,VALLADOLID,20070,75316,0,0,0,95386
180,1993,ZAMORA,1372320,33600,0,0,0,1405920
181,1993,ALBACETE,38441,0,0,0,0,38441
182,1993,CIUDAD REAL,5292,688000,0,0,0,693292
183,1993,CUENCA,294052,0,0,0,0,294052
184,1993,GUADALAJARA,592400,0,0,0,2452000,3044400
185,1993,TOLEDO,528182,1254208,0,0,0,1782390
186,1993,BARCELONA,93996,2804797,0,0,0,2898793
187,1993,GIRONA,275560,50290,1180,0,0,327030
188,1993,LLEIDA,3275870,16000,0,0,0,3291870
189,1993,TARRAGONA,610600,93198,0,0,5728000,6431798
190,1993,CEUTA,0,67680,0,0,0,67680
191,1993,BADAJOZ,184055,3000,0,0,0,187055
192,1993,CACERES,3938466,80,0,0,3722400,7660946
193,1993,LA CORUÑA,597154,4922026,0,0,0,5519180
194,1993,LUGO,947128,0,0,0,0,947128
195,1993,ORENSE,3604014,0,0,0,0,3604014
196,1993,PONTEVEDRA,176986,60240,0,0,0,237226
197,1993,LA RIOJA,59860,0,0,0,0,59860
198,1993,MADRID,143084,13000,0,0,0,156084
199,1993,MELILLA,0,74040,0,0,0,74040
200,1993,MURCIA,75528,1805860,0,0,0,1881388
201,1993,NAVARRA,256508,51684,0,0,0,308192
202,1993,ALAVA,33555,12100,0,0,0,45655
203,1993,GUIPUZCOA,49180,492560,0,0,0,541740
204,1993,VIZCAYA,177466,2079428,0,0,0,2256894
205,1993,ALICANTE,680,0,0,0,0,680
206,1993,CASTELLON,97784,2233308,0,0,0,2331092
207,1993,VALENCIA,2402528,27170,0,0,1987552,4417250
208,1994,ALMERIA,368,663800,0,0,0,664168
209,1994,CADIZ,15680,3146720,820,0,0,3163220
210,1994,CORDOBA,111160,654800,0,0,0,765960
211,1994,GRANADA,165288,20288,0,0,0,185576
212,1994,HUELVA,0,1067150,0,0,0,1067150
213,1994,JAEN,356236,42320,0,0,0,398556
214,1994,MALAGA,963466,245520,0,0,0,1208986
215,1994,SEVILLA,542840,18030,0,0,0,560870
216,1994,HUESCA,2147966,15956,0,0,0,2163922
217,1994,TERUEL,53056,2450000,0,0,0,2503056
218,1994,ZARAGOZA,764662,498094,0,0,0,1262756
219,1994,ASTURIAS,1440120,5583418,0,0,0,7023538
220,1994,BALEARES,0,845062,0,0,0,845062
221,1994,LAS PALMAS,0,1466360,360,0,0,1466720
222,1994,S.C.TENERIFE,1600,1084874,3920,0,0,1090394
223,1994,CANTABRIA,836310,209318,0,0,0,1045628
224,1994,AVILA,71841,0,0,0,0,71841
225,1994,BURGOS,40073,124429,0,0,460000,624502
226,1994,LEON,818042,4608900,0,0,0,5426942
227,1994,PALENCIA,147570,1034410,0,0,0,1181980
228,1994,SALAMANCA,5021404,18200,0,0,0,5039604
229,1994,SEGOVIA,22334,0,0,0,0,22334
230,1994,SORIA,32286,0,0,0,0,32286
231,1994,VALLADOLID,47694,76916,0,0,0,124610
232,1994,ZAMORA,1456208,33600,0,0,0,1489808
233,1994,ALBACETE,38449,0,0,0,0,38449
234,1994,CIUDAD REAL,5292,1159600,0,0,0,1164892
235,1994,CUENCA,294052,0,0,0,0,294052
236,1994,GUADALAJARA,600234,0,0,0,2452000,3052234
237,1994,TOLEDO,527460,1257008,0,0,0,1784468
238,1994,BARCELONA,115654,2871855,0,0,0,2987509
239,1994,GIRONA,301144,80290,1180,0,0,382614
240,1994,LLEIDA,3317432,33600,0,0,0,3351032
241,1994,TARRAGONA,646502,319066,0,0,5728000,6693568
242,1994,CEUTA,0,66240,0,0,0,66240
243,1994,BADAJOZ,184155,3000,0,0,0,187155
244,1994,CACERES,3938730,80,0,0,3722400,7661210
245,1994,LA CORUÑA,652984,4923226,0,0,0,5576210
246,1994,LUGO,947692,0,0,0,0,947692
247,1994,ORENSE,4016734,0,0,0,0,4016734
248,1994,PONTEVEDRA,176986,61440,0,0,0,238426
249,1994,LA RIOJA,75970,4812,0,0,0,80782
250,1994,MADRID,170444,62398,0,0,0,232842
251,1994,MELILLA,0,74192,0,0,0,74192
252,1994,MURCIA,76868,1805860,0,0,0,1882728
253,1994,NAVARRA,266290,75416,6000,0,0,347706
254,1994,ALAVA,33378,23030,0,0,0,56408
255,1994,GUIPUZCOA,46796,513664,0,0,0,560460
256,1994,VIZCAYA,199566,2180924,0,0,0,2380490
257,1994,ALICANTE,680,4650,0,0,0,5330
258,1994,CASTELLON,97784,2425254,0,0,0,2523038
259,1994,VALENCIA,2402528,61854,0,0,1987552,4451934
260,1995,ALMERIA,368,663800,0,0,0,664168
261,1995,CADIZ,15680,3146720,880,0,0,3163280
262,1995,CORDOBA,111160,625600,0,0,0,736760
263,1995,GRANADA,165288,87408,0,0,0,252696
264,1995,HUELVA,0,1107230,0,0,0,1107230
265,1995,JAEN,356236,42320,0,0,0,398556
266,1995,MALAGA,963466,245520,0,0,0,1208986
267,1995,SEVILLA,542840,18030,0,0,0,560870
268,1995,HUESCA,2148054,17796,0,0,0,2165850
269,1995,TERUEL,59896,2450000,0,0,0,2509896
270,1995,ZARAGOZA,763600,498094,1090,0,0,1262784
271,1995,ASTURIAS,1443488,5584478,0,0,0,7027966
272,1995,BALEARES,0,844072,0,0,0,844072
273,1995,LAS PALMAS,0,1642400,360,0,0,1642760
274,1995,S.C.TENERIFE,1600,1421374,4120,0,0,1427094
275,1995,CANTABRIA,849480,209318,0,0,0,1058798
276,1995,AVILA,71941,0,0,0,0,71941
277,1995,BURGOS,40713,124429,0,0,460000,625142
278,1995,LEON,818110,4608900,0,0,0,5427010
279,1995,PALENCIA,147716,1054410,0,0,0,1202126
280,1995,SALAMANCA,5020654,18200,0,0,0,5038854
281,1995,SEGOVIA,22294,0,0,0,0,22294
282,1995,SORIA,32306,0,0,0,0,32306
283,1995,VALLADOLID,47694,76916,0,0,0,124610
284,1995,ZAMORA,1513012,33600,0,0,0,1546612
285,1995,ALBACETE,41889,0,0,0,0,41889
286,1995,CIUDAD REAL,5292,719600,0,0,0,724892
287,1995,CUENCA,294052,0,0,0,0,294052
288,1995,GUADALAJARA,600806,0,0,0,2452000,3052806
289,1995,TOLEDO,541052,1257008,0,0,0,1798060
290,1995,BARCELONA,117100,2874406,0,0,0,2991506
291,1995,GIRONA,301458,67290,1180,0,0,369928
292,1995,LLEIDA,3327248,38000,0,0,0,3365248
293,1995,TARRAGONA,620690,291642,0,0,5728000,6640332
294,1995,CEUTA,0,66240,0,0,0,66240
295,1995,BADAJOZ,194933,3000,0,0,0,197933
296,1995,CACERES,3938898,1040,0,0,3722400,7662338
297,1995,LA CORUÑA,652952,4996826,2400,0,0,5652178
298,1995,LUGO,947692,0,0,0,0,947692
299,1995,ORENSE,4016734,27000,0,0,0,4043734
300,1995,PONTEVEDRA,176986,63040,0,0,0,240026
301,1995,LA RIOJA,80218,4812,0,0,0,85030
302,1995,MADRID,196204,212638,0,0,0,408842
303,1995,MELILLA,0,74192,0,0,0,74192
304,1995,MURCIA,76868,1826360,0,0,0,1903228
305,1995,NAVARRA,267290,76154,6000,0,0,349444
306,1995,ALAVA,33378,23030,0,0,0,56408
307,1995,GUIPUZCOA,46566,512304,0,0,0,558870
308,1995,VIZCAYA,200296,2175604,0,0,0,2375900
309,1995,ALICANTE,2326,4650,0,0,0,6976
310,1995,CASTELLON,97784,2492528,0,0,0,2590312
311,1995,VALENCIA,2402528,131654,0,0,1987552,4521734
312,1996,ALMERIA,368,663800,0,0,0,664168
313,1996,CADIZ,15680,3183480,2760,0,0,3201920
314,1996,CORDOBA,111160,651600,0,0,0,762760
315,1996,GRANADA,165288,87408,0,0,0,252696
316,1996,HUELVA,0,1087530,0,0,0,1087530
317,1996,JAEN,356236,42320,0,0,0,398556
318,1996,MALAGA,963466,244000,0,0,0,1207466
319,1996,SEVILLA,542840,18800,0,0,0,561640
320,1996,HUESCA,2183550,39360,0,0,0,2222910
321,1996,TERUEL,58456,2450000,0,0,0,2508456
322,1996,ZARAGOZA,783504,516448,1090,0,0,1301042
323,1996,ASTURIAS,1444528,5587038,0,0,0,7031566
324,1996,BALEARES,0,844072,0,0,0,844072
325,1996,LAS PALMAS,0,1802400,10920,0,0,1813320
326,1996,S.C.TENERIFE,1600,1427074,3320,0,0,1431994
327,1996,CANTABRIA,849480,242388,0,0,0,1091868
328,1996,AVILA,73911,0,0,0,0,73911
329,1996,BURGOS,40716,139749,0,0,460000,640465
330,1996,LEON,818910,4608900,0,0,0,5427810
331,1996,PALENCIA,147716,1052352,0,0,0,1200068
332,1996,SALAMANCA,5020774,17800,0,0,0,5038574
333,1996,SEGOVIA,21990,0,0,0,0,21990
334,1996,SORIA,32906,0,0,0,0,32906
335,1996,VALLADOLID,47694,99396,0,0,0,147090
336,1996,ZAMORA,1508710,33600,0,0,0,1542310
337,1996,ALBACETE,41889,0,0,0,0,41889
338,1996,CIUDAD REAL,5292,1332000,0,0,0,1337292
339,1996,CUENCA,294052,0,0,0,0,294052
340,1996,GUADALAJARA,599720,37800,0,0,2452000,3089520
341,1996,TOLEDO,541052,1258966,0,0,0,1800018
342,1996,BARCELONA,118799,2927394,0,0,0,3046193
343,1996,GIRONA,299314,67290,1180,0,0,367784
344,1996,LLEIDA,3324126,38000,0,0,0,3362126
345,1996,TARRAGONA,620690,286434,0,0,5844000,6751124
346,1996,CEUTA,0,66240,0,0,0,66240
347,1996,BADAJOZ,194933,0,0,0,0,194933
348,1996,CACERES,3942098,1040,0,0,3807000,7750138
349,1996,LA CORUÑA,662844,5003286,2400,0,0,5668530
350,1996,LUGO,957692,0,0,0,0,957692
351,1996,ORENSE,4017694,23840,0,0,0,4041534
352,1996,PONTEVEDRA,176986,64640,0,0,0,241626
353,1996,LA RIOJA,77486,4812,0,0,0,82298
354,1996,MADRID,196204,189978,0,0,0,386182
355,1996,MELILLA,0,74192,0,0,0,74192
356,1996,MURCIA,76808,1861240,0,0,0,1938048
357,1996,NAVARRA,288110,89214,127600,0,0,504924
358,1996,ALAVA,33378,39100,0,0,0,72478
359,1996,GUIPUZCOA,48302,522914,0,0,0,571216
360,1996,VIZCAYA,179096,2221340,0,0,0,2400436
361,1996,ALICANTE,2326,11240,0,0,0,13566
362,1996,CASTELLON,97784,2589242,0,0,0,2687026
363,1996,VALENCIA,2432268,213954,0,0,1987552,4633774
364,1997,ALMERIA,368,1213800,0,0,0,1214168
365,1997,CADIZ,15680,3267120,2760,0,0,3285560
366,1997,CORDOBA,119512,651600,0,0,0,771112
367,1997,GRANADA,165260,94608,0,0,0,259868
368,1997,HUELVA,0,1098274,0,0,0,1098274
369,1997,JAEN,360536,42320,0,0,0,402856
370,1997,MALAGA,963466,244000,0,0,0,1207466
371,1997,SEVILLA,542840,18800,0,0,0,561640
372,1997,HUESCA,2197750,59718,0,0,0,2257468
373,1997,TERUEL,59176,2510600,0,0,0,2569776
374,1997,ZARAGOZA,783504,589154,31090,0,0,1403748
375,1997,ASTURIAS,1444528,5589262,0,0,0,7033790
376,1997,BALEARES,0,1139652,0,0,0,1139652
377,1997,LAS PALMAS,0,1802400,100980,0,0,1903380
378,1997,S.C.TENERIFE,1600,1428474,35866,0,0,1465940
379,1997,CANTABRIA,849480,248660,0,0,0,1098140
380,1997,AVILA,74236,0,0,0,0,74236
381,1997,BURGOS,39590,148279,0,0,460000,647869
382,1997,LEON,819078,4642140,0,0,0,5461218
383,1997,PALENCIA,148446,1065752,0,0,0,1214198
384,1997,SALAMANCA,5025674,21800,0,0,0,5047474
385,1997,SEGOVIA,21500,540,0,0,0,22040
386,1997,SORIA,32906,500,0,0,0,33406
387,1997,VALLADOLID,47694,91396,0,0,0,139090
388,1997,ZAMORA,1508710,33600,0,0,0,1542310
389,1997,ALBACETE,41121,30000,0,0,0,71121
390,1997,CIUDAD REAL,5292,1357400,0,0,0,1362692
391,1997,CUENCA,294052,1900,0,0,0,295952
392,1997,GUADALAJARA,600986,49400,0,0,2452000,3102386
393,1997,TOLEDO,541052,1323278,0,0,0,1864330
394,1997,BARCELONA,117331,3126784,0,0,0,3244115
395,1997,GIRONA,289382,153578,1180,0,0,444140
396,1997,LLEIDA,3365678,117996,0,0,0,3483674
397,1997,TARRAGONA,620640,482902,0,0,5896000,6999542
398,1997,CEUTA,0,66240,0,0,0,66240
399,1997,BADAJOZ,194933,0,0,0,0,194933
400,1997,CACERES,3942098,1040,0,0,3912200,7855338
401,1997,LA CORUÑA,650364,5031206,2400,0,0,5683970
402,1997,LUGO,957652,0,0,0,0,957652
403,1997,ORENSE,4017694,29540,0,0,0,4047234
404,1997,PONTEVEDRA,175666,68520,0,0,0,244186
405,1997,LA RIOJA,80880,4812,0,0,0,85692
406,1997,MADRID,197274,245066,0,0,0,442340
407,1997,MELILLA,0,89320,0,0,0,89320
408,1997,MURCIA,76328,1861240,0,0,0,1937568
409,1997,NAVARRA,300442,97128,270520,0,0,668090
410,1997,ALAVA,33378,54000,0,0,0,87378
411,1997,GUIPUZCOA,47662,549508,0,0,0,597170
412,1997,VIZCAYA,178596,2222500,0,0,0,2401096
413,1997,ALICANTE,2326,24949,0,0,0,27275
414,1997,CASTELLON,97784,2661220,0,0,0,2759004
415,1997,VALENCIA,2432268,297552,0,0,1987552,4717372
416,1998,ALMERIA,368,1205000,0,0,0,1205368
417,1998,CADIZ,15680,3274610,2760,0,0,3293050
418,1998,CORDOBA,119512,651600,0,0,0,771112
419,1998,GRANADA,165260,102408,0,0,0,267668
420,1998,HUELVA,0,1165474,0,0,0,1165474
421,1998,JAEN,360536,44250,0,0,0,404786
422,1998,MALAGA,963466,244000,0,0,0,1207466
423,1998,SEVILLA,542840,24200,0,0,0,567040
424,1998,HUESCA,2194560,176442,0,0,0,2371002
425,1998,TERUEL,59176,2514404,0,0,0,2573580
426,1998,ZARAGOZA,783504,590222,31090,0,0,1404816
427,1998,ASTURIAS,1450684,5638062,0,0,0,7088746
428,1998,BALEARES,0,1139652,0,0,0,1139652
429,1998,LAS PALMAS,0,1877400,112440,0,0,1989840
430,1998,S.C.TENERIFE,1600,1427074,35866,0,0,1464540
431,1998,CANTABRIA,849398,269740,0,0,0,1119138
432,1998,AVILA,74236,0,0,0,0,74236
433,1998,BURGOS,39550,164458,0,0,466000,670008
434,1998,LEON,818810,4638948,0,0,0,5457758
435,1998,PALENCIA,148446,1060260,0,0,0,1208706
436,1998,SALAMANCA,5027392,21800,0,0,0,5049192
437,1998,SEGOVIA,21500,12860,0,0,0,34360
438,1998,SORIA,32934,4940,0,0,0,37874
439,1998,VALLADOLID,46534,91396,0,0,0,137930
440,1998,ZAMORA,1508710,33600,0,0,0,1542310
441,1998,ALBACETE,41121,30980,0,0,0,72101
442,1998,CIUDAD REAL,5292,1391580,0,0,0,1396872
443,1998,CUENCA,294052,1900,0,0,0,295952
444,1998,GUADALAJARA,600994,49400,0,0,2452000,3102394
445,1998,TOLEDO,541052,1355026,0,0,0,1896078
446,1998,BARCELONA,118060,3178404,0,0,0,3296464
447,1998,GIRONA,288662,188658,1180,0,0,478500
448,1998,LLEIDA,3378828,205012,0,0,0,3583840
449,1998,TARRAGONA,630640,568912,0,0,5916000,7115552
450,1998,CEUTA,0,78840,0,0,0,78840
451,1998,BADAJOZ,194933,0,0,0,0,194933
452,1998,CACERES,3942098,1040,0,0,3914000,7857138
453,1998,LA CORUÑA,650364,5375674,2400,0,0,6028438
454,1998,LUGO,957652,35460,0,0,0,993112
455,1998,ORENSE,4017294,41120,0,0,0,4058414
456,1998,PONTEVEDRA,181766,111964,0,0,0,293730
457,1998,LA RIOJA,80880,17994,0,0,0,98874
458,1998,MADRID,197274,269032,0,0,0,466306
459,1998,MELILLA,0,89320,0,0,0,89320
460,1998,MURCIA,76328,1861240,0,0,0,1937568
461,1998,NAVARRA,307640,122492,477880,0,0,908012
462,1998,ALAVA,33378,61316,0,0,0,94694
463,1998,GUIPUZCOA,49092,596138,0,0,0,645230
464,1998,VIZCAYA,179724,2268028,0,0,0,2447752
465,1998,ALICANTE,2326,24949,0,0,0,27275
466,1998,CASTELLON,97784,2718068,0,0,0,2815852
467,1998,VALENCIA,2439468,305450,0,0,2050000,4794918
468,1999,ALMERIA,368,1205000,0,0,0,1205368
469,1999,CADIZ,15680,3247490,2760,0,0,3265930
470,1999,CORDOBA,119512,651600,0,0,0,771112
471,1999,GRANADA,165260,158638,0,0,0,323898
472,1999,HUELVA,0,1189474,0,0,0,1189474
473,1999,JAEN,360536,93450,0,0,0,453986
474,1999,MALAGA,963466,246760,0,0,0,1210226
475,1999,SEVILLA,546058,67048,0,0,0,613106
476,1999,HUESCA,2194560,238682,0,0,0,2433242
477,1999,TERUEL,59176,2523288,0,0,0,2582464
478,1999,ZARAGOZA,790704,594972,31090,0,0,1416766
479,1999,ASTURIAS,1450684,5628242,0,0,0,7078926
480,1999,BALEARES,0,1219747,0,0,0,1219747
481,1999,LAS PALMAS,0,1877400,112440,0,0,1989840
482,1999,S.C.TENERIFE,1600,1428994,35866,0,0,1466460
483,1999,CANTABRIA,848278,271812,0,0,0,1120090
484,1999,AVILA,74156,0,0,0,0,74156
485,1999,BURGOS,41090,164658,0,0,466000,671748
486,1999,LEON,819710,4654940,0,0,0,5474650
487,1999,PALENCIA,148446,1063188,0,0,0,1211634
488,1999,SALAMANCA,5027292,21800,0,0,0,5049092
489,1999,SEGOVIA,21670,12860,0,0,0,34530
490,1999,SORIA,32634,5380,0,0,0,38014
491,1999,VALLADOLID,46534,101176,0,0,0,147710
492,1999,ZAMORA,1824790,33600,0,0,0,1858390
493,1999,ALBACETE,41121,34052,0,0,0,75173
494,1999,CIUDAD REAL,5292,1375580,0,0,0,1380872
495,1999,CUENCA,294052,29438,0,0,0,323490
496,1999,GUADALAJARA,600986,51476,0,0,2452000,3104462
497,1999,TOLEDO,541052,1381246,0,0,0,1922298
498,1999,BARCELONA,116745,3204849,0,0,0,3321594
499,1999,GIRONA,299216,219964,1180,0,0,520360
500,1999,LLEIDA,3379254,252204,0,0,0,3631458
501,1999,TARRAGONA,630640,597480,0,0,6061460,7289580
502,1999,CEUTA,0,78840,0,0,0,78840
503,1999,BADAJOZ,194933,6000,0,0,0,200933
504,1999,CACERES,3942098,1040,0,0,3914000,7857138
505,1999,LA CORUÑA,650944,5524554,2400,0,0,6177898
506,1999,LUGO,962452,38500,0,0,0,1000952
507,1999,ORENSE,4017294,41120,0,0,0,4058414
508,1999,PONTEVEDRA,181766,132554,0,0,0,314320
509,1999,LA RIOJA,81040,24826,0,0,0,105866
510,1999,MADRID,197274,287766,0,0,0,485040
511,1999,MELILLA,0,84120,0,0,0,84120
512,1999,MURCIA,76328,1861240,0,0,0,1937568
513,1999,NAVARRA,309572,163714,488440,0,0,961726
514,1999,ALAVA,33378,64114,0,0,0,97492
515,1999,GUIPUZCOA,45888,606116,0,0,0,652004
516,1999,VIZCAYA,179724,2297954,0,0,0,2477678
517,1999,ALICANTE,2326,48320,0,0,0,50646
518,1999,CASTELLON,97784,2736832,0,0,0,2834616
519,1999,VALENCIA,2439468,352474,0,0,2050000,4841942
520,2000,ALMERIA,368,1249000,0,0,0,1249368
521,2000,CADIZ,15680,3283490,2760,0,0,3301930
522,2000,CORDOBA,119512,683720,0,0,0,803232
523,2000,GRANADA,165180,159638,0,0,0,324818
524,2000,HUELVA,0,1172274,0,0,0,1172274
525,2000,JAEN,360536,93450,0,0,0,453986
526,2000,MALAGA,963466,246760,0,0,0,1210226
527,2000,SEVILLA,546058,73048,0,0,0,619106
528,2000,HUESCA,2204186,240292,0,0,0,2444478
529,2000,TERUEL,59176,2624332,0,0,0,2683508
530,2000,ZARAGOZA,790704,691092,31090,0,0,1512886
531,2000,ASTURIAS,1460684,5685298,0,0,0,7145982
532,2000,BALEARES,0,1262389,0,0,0,1262389
533,2000,LAS PALMAS,0,1952400,112440,0,0,2064840
534,2000,S.C.TENERIFE,1600,1431310,35866,0,0,1468776
535,2000,CANTABRIA,849398,263132,0,0,0,1112530
536,2000,AVILA,75161,0,0,0,0,75161
537,2000,BURGOS,41785,153778,57420,0,466000,718983
538,2000,LEON,819660,4803324,0,0,0,5622984
539,2000,PALENCIA,148446,1098388,0,0,0,1246834
540,2000,SALAMANCA,5027292,21800,0,0,0,5049092
541,2000,SEGOVIA,21610,12860,0,0,0,34470
542,2000,SORIA,32634,34780,50600,0,0,118014
543,2000,VALLADOLID,46534,103176,0,0,0,149710
544,2000,ZAMORA,1824790,33600,0,0,0,1858390
545,2000,ALBACETE,41121,46980,298320,0,0,386421
546,2000,CIUDAD REAL,5292,1424940,0,0,0,1430232
547,2000,CUENCA,294052,70958,0,0,0,365010
548,2000,GUADALAJARA,600986,51476,0,0,2452000,3104462
549,2000,TOLEDO,541052,1388718,0,0,0,1929770
550,2000,BARCELONA,115095,3224391,0,0,0,3339486
551,2000,GIRONA,303406,225064,1180,0,0,529650
552,2000,LLEIDA,3376362,269224,0,0,0,3645586
553,2000,TARRAGONA,630640,682100,0,0,6249060,7561800
554,2000,CEUTA,0,78840,0,0,0,78840
555,2000,BADAJOZ,194933,9144,0,0,0,204077
556,2000,CACERES,3942098,1040,0,0,3914000,7857138
557,2000,LA CORUÑA,667478,5697354,104400,0,0,6469232
558,2000,LUGO,962452,38500,36000,0,0,1036952
559,2000,ORENSE,4015542,41120,0,0,0,4056662
560,2000,PONTEVEDRA,183756,136304,0,0,0,320060
561,2000,LA RIOJA,81040,32486,0,0,0,113526
562,2000,MADRID,197274,302478,0,0,0,499752
563,2000,MELILLA,0,84120,0,0,0,84120
564,2000,MURCIA,76328,1874440,0,0,0,1950768
565,2000,NAVARRA,318636,171482,722440,0,0,1212558
566,2000,ALAVA,39102,71284,0,0,0,110386
567,2000,GUIPUZCOA,45744,611716,0,0,0,657460
568,2000,VIZCAYA,179724,2187154,0,0,0,2366878
569,2000,ALICANTE,2326,51620,0,0,0,53946
570,2000,CASTELLON,97784,2755500,0,0,0,2853284
571,2000,VALENCIA,2439468,381230,0,0,2050000,4870698
572,2001,ALMERIA,368,1249000,0,0,0,1249368
573,2001,CADIZ,15680,3260422,2760,0,0,3278862
574,2001,CORDOBA,123112,683720,0,0,0,806832
575,2001,GRANADA,165180,235830,0,0,0,401010
576,2001,HUELVA,0,1172274,0,0,0,1172274
577,2001,JAEN,360536,93450,0,0,0,453986
578,2001,MALAGA,963466,274444,0,0,0,1237910
579,2001,SEVILLA,546058,73048,0,0,0,619106
580,2001,HUESCA,2204186,224932,0,0,0,2429118
581,2001,TERUEL,59176,2624332,0,0,0,2683508
582,2001,ZARAGOZA,790704,694624,68490,0,0,1553818
583,2001,ASTURIAS,1460684,5695898,0,0,0,7156582
584,2001,BALEARES,0,1451588,0,0,0,1451588
585,2001,LAS PALMAS,0,1943580,151420,0,0,2095000
586,2001,S.C.TENERIFE,1600,1451010,72180,0,0,1524790
587,2001,CANTABRIA,849398,250710,0,0,0,1100108
588,2001,AVILA,75161,0,0,0,0,75161
589,2001,BURGOS,41135,159037,57420,0,466000,723592
590,2001,LEON,819564,4797084,0,0,0,5616648
591,2001,PALENCIA,147654,1099612,39600,0,0,1286866
592,2001,SALAMANCA,5027292,4000,0,0,0,5031292
593,2001,SEGOVIA,21530,12860,111000,0,0,145390
594,2001,SORIA,35910,34780,50600,0,0,121290
595,2001,VALLADOLID,49114,116976,0,0,0,166090
596,2001,ZAMORA,1824790,45200,116220,0,0,1986210
597,2001,ALBACETE,43148,46980,445170,0,0,535298
598,2001,CIUDAD REAL,5292,1336940,0,0,0,1342232
599,2001,CUENCA,288096,70958,0,0,0,359054
600,2001,GUADALAJARA,600986,61328,0,0,2452000,3114314
601,2001,TOLEDO,541052,1388718,0,0,0,1929770
602,2001,BARCELONA,113094,3231118,0,0,0,3344212
603,2001,GIRONA,307536,229052,1180,0,0,537768
604,2001,LLEIDA,3507200,267324,0,0,0,3774524
605,2001,TARRAGONA,666640,862284,59700,0,6284600,7873224
606,2001,CEUTA,0,78840,0,0,0,78840
607,2001,BADAJOZ,194933,9144,0,0,0,204077
608,2001,CACERES,3942098,1040,0,0,3914000,7857138
609,2001,LA CORUÑA,691308,5796954,562080,0,0,7050342
610,2001,LUGO,962452,44340,67200,0,0,1073992
611,2001,ORENSE,4016742,45820,0,0,0,4062562
612,2001,PONTEVEDRA,183514,136344,0,0,0,319858
613,2001,LA RIOJA,81040,32486,0,0,0,113526
614,2001,MADRID,197274,393902,0,0,0,591176
615,2001,MELILLA,0,84120,0,0,0,84120
616,2001,MURCIA,76328,1907258,0,0,0,1983586
617,2001,NAVARRA,367778,240810,878320,0,0,1486908
618,2001,ALAVA,39102,71284,0,0,0,110386
619,2001,GUIPUZCOA,45744,600554,0,0,0,646298
620,2001,VIZCAYA,178596,2212022,0,0,0,2390618
621,2001,ALICANTE,2326,51620,0,0,0,53946
622,2001,CASTELLON,97784,2761294,0,0,0,2859078
623,2001,VALENCIA,2439468,392972,0,0,2050000,4882440
624,2002,ALMERIA,368,1249000,0,0,0,1249368
625,2002,CADIZ,27240,4854228,1180,0,0,4882648
626,2002,CORDOBA,123112,691720,0,0,0,814832
627,2002,GRANADA,165180,235830,0,0,0,401010
628,2002,HUELVA,0,1172274,0,0,0,1172274
629,2002,JAEN,360536,219034,0,0,0,579570
630,2002,MALAGA,963466,274444,66800,0,0,1304710
631,2002,SEVILLA,546058,131762,0,0,0,677820
632,2002,HUESCA,2204786,224932,0,0,0,2429718
633,2002,TERUEL,59096,2674132,0,0,0,2733228
634,2002,ZARAGOZA,790704,764032,68490,0,0,1623226
635,2002,ASTURIAS,1461568,5745498,0,0,0,7207066
636,2002,BALEARES,0,1525988,0,0,0,1525988
637,2002,LAS PALMAS,0,1946780,151420,0,0,2098200
638,2002,S.C.TENERIFE,1600,1449550,72180,0,0,1523330
639,2002,CANTABRIA,854398,251710,0,0,0,1106108
640,2002,AVILA,75161,0,49000,0,0,124161
641,2002,BURGOS,42635,183231,57420,0,466000,749286
642,2002,LEON,819564,4797084,0,0,0,5616648
643,2002,PALENCIA,147654,1108412,39600,0,0,1295666
644,2002,SALAMANCA,5027292,6076,0,0,0,5033368
645,2002,SEGOVIA,21530,18860,110880,0,0,151270
646,2002,SORIA,36882,34788,50600,0,0,122270
647,2002,VALLADOLID,49114,211514,0,0,0,260628
648,2002,ZAMORA,1824790,45200,116060,0,0,1986050
649,2002,ALBACETE,48041,46980,559920,0,0,654941
650,2002,CIUDAD REAL,5292,1352540,0,0,0,1357832
651,2002,CUENCA,288264,70858,136000,0,0,495122
652,2002,GUADALAJARA,600986,61336,0,0,2452000,3114322
653,2002,TOLEDO,541052,1392698,0,0,0,1933750
654,2002,BARCELONA,112306,4094021,0,0,0,4206327
655,2002,GIRONA,302474,250580,1180,0,0,554234
656,2002,LLEIDA,3513192,260854,0,0,0,3774046
657,2002,TARRAGONA,662640,882200,59700,0,6284600,7889140
658,2002,CEUTA,0,78840,0,0,0,78840
659,2002,BADAJOZ,194933,11844,0,0,0,206777
660,2002,CACERES,3952928,1040,0,0,3914000,7867968
661,2002,LA CORUÑA,789460,6028390,670680,0,0,7488530
662,2002,LUGO,963812,52740,67200,0,0,1083752
663,2002,ORENSE,4016742,41120,0,0,0,4057862
664,2002,PONTEVEDRA,194754,148720,0,0,0,343474
665,2002,LA RIOJA,81040,32486,0,0,0,113526
666,2002,MADRID,197274,413642,0,0,0,610916
667,2002,MELILLA,0,84120,0,0,0,84120
668,2002,MURCIA,76328,1539778,0,0,0,1616106
669,2002,NAVARRA,318332,1029830,1158320,2400,0,2508882
670,2002,ALAVA,41100,116284,0,0,0,157384
671,2002,GUIPUZCOA,45628,616304,0,0,0,661932
672,2002,VIZCAYA,184900,2236682,0,0,0,2421582
673,2002,ALICANTE,2326,52245,0,0,0,54571
674,2002,CASTELLON,97784,2770222,0,0,0,2868006
675,2002,VALENCIA,2575468,436518,0,0,2050000,5061986
676,2003,ALMERIA,368,1249000,0,0,0,1249368
677,2003,CADIZ,27240,4854228,3150,0,0,4884618
678,2003,CORDOBA,133112,693160,0,0,0,826272
679,2003,GRANADA,167260,237240,0,0,0,404500
680,2003,HUELVA,0,1081746,0,0,0,1081746
681,2003,JAEN,360536,238434,0,0,0,598970
682,2003,MALAGA,963466,340698,66800,0,0,1370964
683,2003,SEVILLA,546058,167234,0,0,0,713292
684,2003,HUESCA,2203556,262772,187400,0,0,2653728
685,2003,TERUEL,59096,2674252,0,0,0,2733348
686,2003,ZARAGOZA,790704,761416,143490,0,0,1695610
687,2003,ASTURIAS,1533554,5764640,276800,0,0,7574994
688,2003,BALEARES,0,1759789,0,0,0,1759789
689,2003,LAS PALMAS,0,2248780,151420,0,0,2400200
690,2003,S.C.TENERIFE,1600,1724990,72180,0,0,1798770
691,2003,CANTABRIA,856918,251710,0,0,0,1108628
692,2003,AVILA,75161,0,66600,0,0,141761
693,2003,BURGOS,42672,197991,106720,0,466000,813383
694,2003,LEON,819664,4797084,0,0,0,5616748
695,2003,PALENCIA,147496,1090762,138200,0,0,1376458
696,2003,SALAMANCA,5231120,6076,0,0,0,5237196
697,2003,SEGOVIA,21530,18860,110880,0,0,151270
698,2003,SORIA,35862,109688,50600,0,0,196150
699,2003,VALLADOLID,49114,211514,0,0,0,260628
700,2003,ZAMORA,1837950,44720,380660,0,0,2263330
701,2003,ALBACETE,48041,50310,731270,0,0,829621
702,2003,CIUDAD REAL,5292,1352540,0,0,0,1357832
703,2003,CUENCA,288264,115958,334000,0,0,738222
704,2003,GUADALAJARA,610146,61336,0,0,2452000,3123482
705,2003,TOLEDO,551792,1392698,0,0,0,1944490
706,2003,BARCELONA,116639,3953915,0,0,0,4070554
707,2003,GIRONA,303594,238308,1180,0,0,543082
708,2003,LLEIDA,3562010,260854,0,0,0,3822864
709,2003,TARRAGONA,662640,1682332,59700,0,6293600,8698272
710,2003,CEUTA,0,78840,0,0,0,78840
711,2003,BADAJOZ,194933,11844,0,0,0,206777
712,2003,CACERES,3952928,1040,0,0,3914000,7867968
713,2003,LA CORUÑA,789460,6188140,946660,0,0,7924260
714,2003,LUGO,979534,52740,232700,0,0,1264974
715,2003,ORENSE,4165982,41120,282480,0,0,4489582
716,2003,PONTEVEDRA,204754,152860,161900,0,0,519514
717,2003,LA RIOJA,81040,32486,440040,0,0,553566
718,2003,MADRID,197606,421516,0,0,0,619122
719,2003,MELILLA,0,84120,0,0,0,84120
720,2003,MURCIA,76328,1572670,0,0,0,1648998
721,2003,NAVARRA,318530,1838582,1215120,2400,0,3374632
722,2003,ALAVA,41277,103484,26970,0,0,171731
723,2003,GUIPUZCOA,45628,682634,0,0,0,728262
724,2003,VIZCAYA,184900,3836682,0,0,0,4021582
725,2003,ALICANTE,2326,60253,0,0,0,62579
726,2003,CASTELLON,97784,4384130,0,0,0,4481914
727,2003,VALENCIA,2588368,440134,0,0,2190000,5218502
728,2004,ALMERIA,368,1144000,0,0,0,1144368
729,2004,CADIZ,28172,7809222,187550,0,0,8024944
730,2004,CORDOBA,133512,693160,0,0,0,826672
731,2004,GRANADA,167260,237240,0,0,0,404500
732,2004,HUELVA,0,1839206,0,0,0,1839206
733,2004,JAEN,360536,219034,0,0,0,579570
734,2004,MALAGA,964466,91178,66800,0,0,1122444
735,2004,SEVILLA,552990,195190,0,0,0,748180
736,2004,HUESCA,2217140,269294,259400,0,0,2745834
737,2004,TERUEL,59156,2674252,0,0,0,2733408
738,2004,ZARAGOZA,800712,781136,143690,0,0,1725538
739,2004,ASTURIAS,1533554,5763640,276800,0,0,7573994
740,2004,BALEARES,0,1790789,0,0,0,1790789
741,2004,LAS PALMAS,0,2464980,191620,0,0,2656600
742,2004,S.C.TENERIFE,1600,1900490,85008,0,0,1987098
743,2004,CANTABRIA,858208,403938,0,0,0,1262146
744,2004,AVILA,75061,0,107520,0,0,182581
745,2004,BURGOS,42672,200090,279270,0,466000,988032
746,2004,LEON,861668,4801084,82500,0,0,5745252
747,2004,PALENCIA,147536,1094244,291400,0,0,1533180
748,2004,SALAMANCA,5230964,6076,0,0,0,5237040
749,2004,SEGOVIA,21530,21360,29040,0,0,71930
750,2004,SORIA,39544,118552,220800,0,0,378896
751,2004,VALLADOLID,54116,212506,0,0,0,266622
752,2004,ZAMORA,1845596,45520,406260,0,0,2297376
753,2004,ALBACETE,48042,50310,913120,0,0,1011472
754,2004,CIUDAD REAL,5292,1353500,0,0,0,1358792
755,2004,CUENCA,288164,124758,763600,0,0,1176522
756,2004,GUADALAJARA,610146,64120,84800,0,2452000,3211066
757,2004,TOLEDO,551028,1393162,63000,0,0,2007190
758,2004,BARCELONA,116115,3476359,0,0,0,3592474
759,2004,GIRONA,304694,238270,1180,0,0,544144
760,2004,LLEIDA,3592576,267194,0,0,0,3859770
761,2004,TARRAGONA,702640,2481732,59700,0,6293600,9537672
762,2004,CEUTA,0,78840,0,0,0,78840
763,2004,BADAJOZ,195778,11844,0,0,0,207622
764,2004,CACERES,3953008,1040,0,0,3914000,7868048
765,2004,LA CORUÑA,829340,6125264,1021880,0,0,7976484
766,2004,LUGO,980188,52500,1091200,0,0,2123888
767,2004,ORENSE,4134562,54540,383000,0,0,4572102
768,2004,PONTEVEDRA,209210,151912,162000,0,0,523122
769,2004,LA RIOJA,90020,1561270,440040,0,0,2091330
770,2004,MADRID,197606,418614,0,0,0,616220
771,2004,MELILLA,0,84120,0,0,0,84120
772,2004,MURCIA,76532,1587592,84200,0,0,1748324
773,2004,NAVARRA,318724,1838582,1494120,2400,0,3653826
774,2004,ALAVA,41153,103115,26970,0,0,171238
775,2004,GUIPUZCOA,48010,686010,0,0,0,734020
776,2004,VIZCAYA,183688,4820842,0,0,0,5004530
777,2004,ALICANTE,2326,61620,0,0,0,63946
778,2004,CASTELLON,98904,4437056,0,0,0,4535960
779,2004,VALENCIA,2604508,461258,0,0,2190000,5255766
780,2005,ALMERIA,368,1158900,0,0,0,1159268
781,2005,CADIZ,28172,8609222,609154,0,0,9246548
782,2005,CORDOBA,133112,718560,0,0,0,851672
783,2005,GRANADA,167066,237240,101400,0,0,505706
784,2005,HUELVA,0,3345206,438300,0,0,3783506
785,2005,JAEN,361906,219034,30360,0,0,611300
786,2005,MALAGA,964558,91178,94000,0,0,1149736
787,2005,SEVILLA,552030,211594,119560,0,0,883184
788,2005,HUESCA,2216422,269774,322100,0,0,2808296
789,2005,TERUEL,52548,2687380,50160,0,0,2790088
790,2005,ZARAGOZA,800708,779028,2334050,0,0,3913786
791,2005,ASTURIAS,1533554,5813320,324700,0,0,7671574
792,2005,BALEARES,0,1695789,3200,0,0,1698989
793,2005,LAS PALMAS,0,2538980,195220,0,0,2734200
794,2005,S.C.TENERIFE,1600,2065350,85008,0,0,2151958
795,2005,CANTABRIA,858208,404538,0,0,0,1262746
796,2005,AVILA,75161,0,110880,0,0,186041
797,2005,BURGOS,42672,200880,523342,0,466000,1232894
798,2005,LEON,861660,4536884,143700,0,0,5542244
799,2005,PALENCIA,147496,1094244,291400,0,0,1533140
800,2005,SALAMANCA,5230080,6076,75000,0,0,5311156
801,2005,SEGOVIA,21530,79920,97040,0,0,198490
802,2005,SORIA,38944,118552,951300,0,0,1108796
803,2005,VALLADOLID,52006,253506,0,0,0,305512
804,2005,ZAMORA,1865076,45520,671860,0,0,2582456
805,2005,ALBACETE,77553,50310,1140580,0,0,1268443
806,2005,CIUDAD REAL,5292,1353500,152000,0,0,1510792
807,2005,CUENCA,288264,124758,1060200,0,0,1473222
808,2005,GUADALAJARA,610146,64120,524700,0,2452000,3650966
809,2005,TOLEDO,551028,2111622,105500,0,0,2768150
810,2005,BARCELONA,118592,3662861,66820,0,0,3848273
811,2005,GIRONA,303022,261170,1180,0,0,565372
812,2005,LLEIDA,3477114,343686,0,0,0,3820800
813,2005,TARRAGONA,664104,2457732,187650,0,6293600,9603086
814,2005,CEUTA,0,78840,0,0,0,78840
815,2005,BADAJOZ,246178,12244,0,0,0,258422
816,2005,CACERES,3852208,1040,0,0,3914000,7767248
817,2005,LA CORUÑA,829392,6113740,1935230,0,0,8878362
818,2005,LUGO,983628,62500,1927380,0,0,2973508
819,2005,ORENSE,4151562,55420,428580,0,0,4635562
820,2005,PONTEVEDRA,224360,151912,605120,0,0,981392
821,2005,LA RIOJA,92380,1561392,820360,0,0,2474132
822,2005,MADRID,197606,477236,0,0,0,674842
823,2005,MELILLA,0,84120,0,0,0,84120
824,2005,MURCIA,78158,3954792,100398,0,0,4133348
825,2005,NAVARRA,317286,1849612,1916120,2400,0,4085418
826,2005,ALAVA,41277,149735,109250,0,0,300262
827,2005,GUIPUZCOA,47226,690062,0,0,0,737288
828,2005,VIZCAYA,185416,6422066,143000,0,0,6750482
829,2005,ALICANTE,2326,62953,0,0,0,65279
830,2005,CASTELLON,98904,4490270,0,0,0,4589174
831,2005,VALENCIA,2644424,442550,40980,0,2190000,5317954
832,2006,ALMERIA,368,1158900,0,703,0,1159971
833,2006,CADIZ,28188,8609222,816134,14,0,9453558
834,2006,CORDOBA,133112,822760,0,972,0,956844
835,2006,GRANADA,167066,237240,224000,2174,0,630480
836,2006,HUELVA,0,4227006,117400,388,0,4344794
837,2006,JAEN,361906,219034,30360,4194,0,615494
838,2006,MALAGA,964558,91178,110000,746,0,1166482
839,2006,SEVILLA,552030,211594,119560,7870,0,891054
840,2006,HUESCA,2216422,271774,438300,1302,0,2927798
841,2006,TERUEL,52548,4237880,50160,640,0,4341228
842,2006,ZARAGOZA,800708,871376,2487750,1236,0,4161070
843,2006,ASTURIAS,1533634,5754120,752700,448,0,8040902
844,2006,BALEARES,0,1822663,3200,1143,0,1827006
845,2006,LAS PALMAS,0,2914980,250514,1966,0,3167460
846,2006,S.C.TENERIFE,1600,2212950,113526,8622,0,2336698
847,2006,CANTABRIA,852728,427338,0,1020,0,1281086
848,2006,AVILA,75161,0,132130,261,0,207552
849,2006,BURGOS,42467,198684,801333,2215,466000,1510699
850,2006,LEON,860960,4526624,146700,2544,0,5536828
851,2006,PALENCIA,146766,1093020,799400,5710,0,2044896
852,2006,SALAMANCA,5229960,57434,62900,3912,0,5354206
853,2006,SEGOVIA,21530,50640,165040,912,0,238122
854,2006,SORIA,38944,147932,1082900,2436,0,1272212
855,2006,VALLADOLID,52006,256306,0,10476,0,318788
856,2006,ZAMORA,1793156,27920,695860,9106,0,2526042
857,2006,ALBACETE,77553,51474,1471080,6540,0,1606647
858,2006,CIUDAD REAL,1556,1351100,304000,2676,0,1659332
859,2006,CUENCA,288264,122858,1159200,7684,0,1578006
860,2006,GUADALAJARA,610146,64120,779260,1552,2452000,3907078
861,2006,TOLEDO,551300,2916032,247500,8754,0,3723586
862,2006,BARCELONA,121160,3247477,66820,5691,0,3441148
863,2006,GIRONA,306914,226824,1180,1092,0,536010
864,2006,LLEIDA,3782216,426026,0,4540,0,4212782
865,2006,TARRAGONA,664104,2457732,155900,1738,6293600,9573074
866,2006,CEUTA,0,78840,0,0,0,78840
867,2006,BADAJOZ,246178,12244,0,405,0,258827
868,2006,CACERES,3852208,1040,0,3522,3914000,7770770
869,2006,LA CORUÑA,831232,7734870,2018610,348,0,10585060
870,2006,LUGO,983628,62500,2280980,774,0,3327882
871,2006,ORENSE,4182010,55420,455780,394,0,4693604
872,2006,PONTEVEDRA,234160,149652,605120,1020,0,989952
873,2006,LA RIOJA,92380,1562992,876360,3018,0,2534750
874,2006,MADRID,197606,473834,0,16860,0,688300
875,2006,MELILLA,0,84120,0,20,0,84140
876,2006,MURCIA,78158,7984672,125898,18034,0,8206762
877,2006,NAVARRA,309714,1850744,1984820,63060,0,4208338
878,2006,ALAVA,41277,102775,109250,1367,0,254669
879,2006,GUIPUZCOA,48186,676018,0,2362,0,726566
880,2006,VIZCAYA,185416,6414512,143000,2256,0,6745184
881,2006,ALICANTE,2326,62953,0,7858,0,73137
882,2006,CASTELLON,98904,4529572,657000,6904,0,5292380
883,2006,VALENCIA,2645104,444428,40980,15264,2190000,5335776
884,2007,ALMERIA,368,1179960,179800,5547,0,1365675
885,2007,CADIZ,28188,8588582,1201434,880,0,9819084
886,2007,CORDOBA,133112,857880,0,7916,0,998908
887,2007,GRANADA,167066,237240,657600,28450,0,1090356
888,2007,HUELVA,0,4267934,88700,14138,0,4370772
889,2007,JAEN,365906,201004,60360,16004,0,643274
890,2007,MALAGA,964558,115178,110000,1634,0,1191370
891,2007,SEVILLA,552378,205754,177860,43408,0,979400
892,2007,HUESCA,2216422,315034,486300,3802,0,3021558
893,2007,TERUEL,52548,4237760,322360,2336,0,4615004
894,2007,ZARAGOZA,800684,2815636,2497010,10560,0,6123890
895,2007,ASTURIAS,1533634,5618970,968600,582,0,8121786
896,2007,BALEARES,0,1822663,6200,1493,0,1830356
897,2007,LAS PALMAS,0,2914980,274614,6688,0,3196282
898,2007,S.C.TENERIFE,1600,2212950,137626,39374,0,2391550
899,2007,CANTABRIA,853800,427338,35700,1664,0,1318502
900,2007,AVILA,75161,0,138730,6977,0,220868
901,2007,BURGOS,42119,197700,853433,5662,466000,1564914
902,2007,LEON,866792,4546424,311500,6172,0,5730888
903,2007,PALENCIA,147496,1093020,696360,11940,0,1948816
904,2007,SALAMANCA,5230080,57434,137900,35820,0,5461234
905,2007,SEGOVIA,21630,50640,109040,4382,0,185692
906,2007,SORIA,38944,147932,1235360,18376,0,1440612
907,2007,VALLADOLID,52006,256306,176250,36670,0,521232
908,2007,ZAMORA,1793156,27920,680220,34534,0,2535830
909,2007,ALBACETE,86393,51310,1680640,63881,0,1882224
910,2007,CIUDAD REAL,1556,1343100,404000,26294,0,1774950
911,2007,CUENCA,319876,122858,1396200,96974,0,1935908
912,2007,GUADALAJARA,610286,64036,917260,8334,2452000,4051916
913,2007,TOLEDO,551300,2966920,167014,66176,0,3751410
914,2007,BARCELONA,121305,3231151,91730,12125,0,3456311
915,2007,GIRONA,306874,226824,1180,5484,0,540362
916,2007,LLEIDA,3849550,541272,180000,26060,0,4596882
917,2007,TARRAGONA,664104,4045494,414850,20918,6293600,11438966
918,2007,CEUTA,0,78840,0,0,0,78840
919,2007,BADAJOZ,246178,12244,0,20523,0,278945
920,2007,CACERES,3852208,1040,0,78310,3914000,7845558
921,2007,LA CORUÑA,830712,8610294,2166910,640,0,11608556
922,2007,LUGO,983628,62500,2363180,2078,0,3411386
923,2007,ORENSE,4211426,55420,607980,562,0,4875388
924,2007,PONTEVEDRA,262160,140972,690020,2272,0,1095424
925,2007,LA RIOJA,92290,1562992,876360,16118,0,2547760
926,2007,MADRID,197606,479952,0,25730,0,703288
927,2007,MELILLA,0,154800,0,20,0,154820
928,2007,MURCIA,78438,8010072,289978,138104,0,8516592
929,2007,NAVARRA,313040,2659152,1879820,123168,0,4975180
930,2007,ALAVA,41277,87395,109250,3025,0,240947
931,2007,GUIPUZCOA,48186,681018,76000,4122,0,809326
932,2007,VIZCAYA,185416,6451962,160000,4362,0,6801740
933,2007,ALICANTE,20980,61841,0,46299,0,129120
934,2007,CASTELLON,98904,6089744,977600,16820,0,7183068
935,2007,VALENCIA,2645104,2792190,40980,45972,2190000,7714246
936,2008,ALMERIA,368,1179960,293150,57575,0,1531053
937,2008,CADIZ,28188,10469422,1923484,88914,0,12510008
938,2008,CORDOBA,133112,899664,0,298780,0,1331556
939,2008,GRANADA,167066,239040,670600,251282,0,1327988
940,2008,HUELVA,0,4159514,139700,81518,0,4380732
941,2008,JAEN,365906,300968,60720,131786,0,859380
942,2008,MALAGA,964558,129238,278300,63348,0,1435444
943,2008,SEVILLA,552378,197606,177860,292610,0,1220454
944,2008,HUESCA,2216422,303710,486300,29408,0,3035840
945,2008,TERUEL,52548,4222856,322360,67140,0,4664904
946,2008,ZARAGOZA,803984,2836136,2531950,140254,0,6312324
947,2008,ASTURIAS,1534034,6438714,1067200,1072,0,9041020
948,2008,BALEARES,0,2008860,6676,51513,0,2067049
949,2008,LAS PALMAS,0,3084780,274614,55734,0,3415128
950,2008,S.C.TENERIFE,1600,2212950,137626,132934,0,2485110
951,2008,CANTABRIA,853800,421128,35700,3462,0,1314090
952,2008,AVILA,75161,0,132130,47347,0,254638
953,2008,BURGOS,41549,194980,1105133,18404,466000,1826066
954,2008,LEON,867072,4543504,394700,35104,0,5840380
955,2008,PALENCIA,146766,1092380,759160,46462,0,2044768
956,2008,SALAMANCA,5230040,57434,137900,96352,0,5521726
957,2008,SEGOVIA,21630,50640,109040,43184,0,224494
958,2008,SORIA,38944,147484,1298260,37114,0,1521802
959,2008,VALLADOLID,51836,258286,176250,155254,0,641626
960,2008,ZAMORA,1793156,27920,873820,129084,0,2823980
961,2008,ALBACETE,86393,50210,1867067,274428,0,2278098
962,2008,CIUDAD REAL,1556,1343540,404000,359592,0,2108688
963,2008,CUENCA,319876,128498,1508200,398508,0,2355082
964,2008,GUADALAJARA,610286,64036,1206460,44448,2452000,4377230
965,2008,TOLEDO,551300,2965356,167014,296080,0,3979750
966,2008,BARCELONA,123023,2761993,91730,50379,0,3027125
967,2008,GIRONA,306094,187424,1180,35706,0,530404
968,2008,LLEIDA,3849394,424246,268000,149510,0,4691150
969,2008,TARRAGONA,664104,5006794,438800,60208,6293600,12463506
970,2008,CEUTA,0,78840,0,0,0,78840
971,2008,BADAJOZ,246178,13429,0,255855,0,515462
972,2008,CACERES,3852208,0,0,321366,3914000,8087574
973,2008,LA CORUÑA,913220,8581014,2319230,3158,0,11816622
974,2008,LUGO,988028,62500,2702280,5204,0,3758012
975,2008,ORENSE,4230426,55420,542880,2678,0,4831404
976,2008,PONTEVEDRA,337714,150476,842944,6836,0,1337970
977,2008,LA RIOJA,92290,1565498,896360,161692,0,2715840
978,2008,MADRID,197606,451172,0,48224,0,697002
979,2008,MELILLA,0,168800,0,220,0,169020
980,2008,MURCIA,78438,7997992,295372,597866,0,8969668
981,2008,NAVARRA,314564,2663534,1937654,252850,0,5168602
982,2008,ALAVA,41277,87395,109250,9337,0,247259
983,2008,GUIPUZCOA,47596,780186,76000,8020,0,911802
984,2008,VIZCAYA,185416,6452066,177000,6666,0,6821148
985,2008,ALICANTE,2326,61641,0,111979,0,175946
986,2008,CASTELLON,98904,6108146,1117600,77282,0,7401932
987,2008,VALENCIA,2645104,2771642,246180,181980,2190000,8034906
988,2009,ALMERIA,368,1179960,496400,57949,0,1734677
989,2009,CADIZ,33944,10460742,3431428,99834,0,14025948
990,2009,CORDOBA,134472,905864,0,508310,0,1548646
991,2009,GRANADA,367266,238840,938200,157054,0,1701360
992,2009,HUELVA,10000,4470594,139700,103410,0,4723704
993,2009,JAEN,365882,350948,60360,133466,0,910656
994,2009,MALAGA,973590,1011238,863600,80708,0,2929136
995,2009,SEVILLA,607770,197606,384620,321858,0,1511854
996,2009,HUESCA,2225380,307850,613970,28752,0,3175952
997,2009,TERUEL,52848,4192968,471820,91114,0,4808750
998,2009,ZARAGOZA,796908,2823576,4089950,174002,0,7884436
999,2009,ASTURIAS,1547320,6479590,1235200,1086,0,9263196
1000,2009,BALEARES,0,2187018,10352,52458,0,2249828
1001,2009,LAS PALMAS,0,3087780,164780,58748,0,3311308
1002,2009,S.C.TENERIFE,1600,2282930,68758,133938,0,2487226
1003,2009,CANTABRIA,900256,410060,53908,3586,0,1367810
1004,2009,AVILA,81331,0,202220,47263,0,330814
1005,2009,BURGOS,41559,193780,1444036,18966,466000,2164341
1006,2009,LEON,895128,4586224,580500,35272,0,6097124
1007,2009,PALENCIA,146806,1092380,1118760,42870,0,2400816
1008,2009,SALAMANCA,5027564,57434,161280,98684,0,5344962
1009,2009,SEGOVIA,23250,76110,165040,43184,0,307584
1010,2009,SORIA,39704,172660,2380440,37114,0,2629918
1011,2009,VALLADOLID,51836,232956,352500,140832,0,778124
1012,2009,ZAMORA,1782996,51920,1617080,129330,0,3581326
1013,2009,ALBACETE,85628,50230,2374607,274428,0,2784893
1014,2009,CIUDAD REAL,101556,1364926,636000,338420,0,2440902
1015,2009,CUENCA,321186,126360,1877800,399344,0,2724690
1016,2009,GUADALAJARA,624238,62028,1790436,45256,2452000,4973958
1017,2009,TOLEDO,559340,2356592,214928,298412,0,3429272
1018,2009,BARCELONA,121952,2750057,257460,52687,0,3182156
1019,2009,GIRONA,314190,183660,1180,37948,0,536978
1020,2009,LLEIDA,3813460,438524,536000,149510,0,4937494
1021,2009,TARRAGONA,667724,5081724,877700,60632,6293680,12981460
1022,2009,CEUTA,0,72800,0,0,0,72800
1023,2009,BADAJOZ,287988,17429,0,256176,0,561593
1024,2009,CACERES,3851408,0,0,295266,3914000,8060674
1025,2009,LA CORUÑA,892872,8495502,2929410,3328,0,12321112
1026,2009,LUGO,1169670,62500,4381860,5362,0,5619392
1027,2009,ORENSE,4294462,58580,664960,2678,0,5020680
1028,2009,PONTEVEDRA,380328,143370,1194688,6844,0,1725230
1029,2009,LA RIOJA,92278,1576150,1011540,156656,0,2836624
1030,2009,MADRID,198582,476508,0,51884,0,726974
1031,2009,MELILLA,0,168800,0,220,0,169020
1032,2009,MURCIA,80980,8061272,328964,597762,0,9068978
1033,2009,NAVARRA,322312,2644804,2109640,251984,0,5328740
1034,2009,ALAVA,59608,83225,150635,9438,0,302906
1035,2009,GUIPUZCOA,46946,792986,76000,8184,0,924116
1036,2009,VIZCAYA,185384,6452514,50500,7074,0,6695472
1037,2009,ALICANTE,2326,60847,0,95540,0,158713
1038,2009,CASTELLON,98900,4036696,2299200,77282,0,6512078
1039,2009,VALENCIA,2629284,2878682,973960,181668,2190000,8853594
1040,2010,ALMERIA,368,1187960,435050,71233,0,1694611
1041,2010,CADIZ,33012,9454742,2466014,111258,0,12065026
1042,2010,CORDOBA,234472,906064,0,330104,0,1470640
1043,2010,GRANADA,366354,237920,786000,163084,0,1553358
1044,2010,HUELVA,10000,4556714,680100,118782,0,5365596
1045,2010,JAEN,365882,410328,60360,158396,0,994966
1046,2010,MALAGA,973590,959558,908200,85016,0,2926364
1047,2010,SEVILLA,908098,161338,258760,348562,0,1676758
1048,2010,HUESCA,2215858,310908,492970,55682,0,3075418
1049,2010,TERUEL,50608,4192968,322360,49634,0,4615570
1050,2010,ZARAGOZA,798588,3113376,2608700,164736,0,6685400
1051,2010,ASTURIAS,1547796,7336982,1124600,1240,0,10010618
1052,2010,BALEARES,0,2269219,6676,56906,0,2332801
1053,2010,LAS PALMAS,0,3087780,318150,73082,0,3479012
1054,2010,S.C.TENERIFE,1600,2524530,100050,179354,0,2805534
1055,2010,CANTABRIA,914056,496968,86140,3692,0,1500856
1056,2010,AVILA,81331,0,211730,54786,0,347847
1057,2010,BURGOS,44297,193680,1461882,24212,466000,2190071
1058,2010,LEON,895128,4616488,910500,65756,0,6487872
1059,2010,PALENCIA,152738,1162280,1167360,47688,0,2530066
1060,2010,SALAMANCA,5027564,57434,86280,107614,0,5278892
1061,2010,SEGOVIA,23250,76110,233040,46304,0,378704
1062,2010,SORIA,37286,180660,2032540,37300,0,2287786
1063,2010,VALLADOLID,51828,204330,176250,180740,0,613148
1064,2010,ZAMORA,1784796,51920,1081820,137700,0,3056236
1065,2010,ALBACETE,87728,50230,2131990,283845,0,2553793
1066,2010,CIUDAD REAL,101556,1402942,404000,342098,0,2250596
1067,2010,CUENCA,321410,126360,1652200,444626,0,2544596
1068,2010,GUADALAJARA,624238,64026,1267960,50276,2132000,4138500
1069,2010,TOLEDO,559068,2366684,167014,303564,0,3396330
1070,2010,BARCELONA,124951,4398875,219000,70259,0,4813085
1071,2010,GIRONA,306454,185650,1180,41198,0,534482
1072,2010,LLEIDA,3801122,438524,391800,141760,0,4773206
1073,2010,TARRAGONA,667724,4306618,1094120,60452,6293680,12422594
1074,2010,CEUTA,0,72800,0,0,0,72800
1075,2010,BADAJOZ,437788,21254,0,302030,0,761072
1076,2010,CACERES,3851408,0,0,332192,3914000,8097600
1077,2010,LA CORUÑA,779518,8505194,2567550,3014,0,11855276
1078,2010,LUGO,1170878,62500,2985240,5942,0,4224560
1079,2010,ORENSE,4278364,58580,681960,3334,0,5022238
1080,2010,PONTEVEDRA,388888,143370,909544,7694,0,1449496
1081,2010,LA RIOJA,91492,1582782,901160,158462,0,2733896
1082,2010,MADRID,1118390,542816,0,71652,0,1732858
1083,2010,MELILLA,0,168800,0,114,0,168914
1084,2010,MURCIA,80980,7999500,409772,679830,0,9170082
1085,2010,NAVARRA,333084,2686082,2005974,270720,0,5295860
1086,2010,ALAVA,61812,69845,150630,10116,0,292403
1087,2010,GUIPUZCOA,47856,784874,76000,9732,0,918462
1088,2010,VIZCAYA,185384,6524286,169000,8222,0,6886892
1089,2010,ALICANTE,2326,59173,0,109088,0,170587
1090,2010,CASTELLON,98900,4002182,1256600,82732,0,5440414
1091,2010,VALENCIA,2460224,2880304,800880,225962,2184040,8551410
1092,2011,ALMERIA,0,1187900,386300,5547,0,1579747
1093,2011,CADIZ,223698,9607340,2169274,123800,0,12124112
1094,2011,CORDOBA,280672,872584,0,222958,0,1376214
1095,2011,GRANADA,416194,242718,772400,97225,0,1528537
1096,2011,HUELVA,9743,4509854,895000,72069,0,5486666
1097,2011,JAEN,353110,453808,60360,91002,0,958280
1098,2011,MALAGA,1017330,1014318,1302850,77000,0,3411498
1099,2011,SEVILLA,1073402,153136,288660,213704,0,1728902
1100,2011,HUESCA,2216585,310198,669435,32117,0,3228335
1101,2011,TERUEL,49808,4189624,294630,26168,0,4560230
1102,2011,ZARAGOZA,793088,3071856,2867765,92280,0,6824989
1103,2011,ASTURIAS,1228463,7281018,1176900,1543,0,9687924
1104,2011,BALEARES,0,906349,6200,1493,0,914042
1105,2011,LAS PALMAS,0,3087780,241465,47344,0,3376589
1106,2011,S.C.TENERIFE,1600,2682770,68810,113687,0,2866867
1107,2011,CANTABRIA,917442,616324,86140,4000,0,1623906
1108,2011,AVILA,85223,0,268850,6977,0,361050
1109,2011,BURGOS,44073,186824,1750832,5662,460000,2447391
1110,2011,LEON,927191,4559188,1156000,42086,0,6684465
1111,2011,PALENCIA,152738,1162380,1479160,31970,0,2826248
1112,2011,SALAMANCA,5027560,55576,112090,76910,0,5272136
1113,2011,SEGOVIA,21128,75966,233040,25631,0,355765
1114,2011,SORIA,37032,172692,2070500,29188,0,2309412
1115,2011,VALLADOLID,50281,206984,176250,132335,0,565850
1116,2011,ZAMORA,1783124,51640,953770,99267,0,2887801
1117,2011,ALBACETE,85628,51230,2172070,63881,0,2372809
1118,2011,CIUDAD REAL,150278,1403382,440000,187147,0,2180807
1119,2011,CUENCA,324583,127360,1654300,273487,0,2379730
1120,2011,GUADALAJARA,612340,64026,1571532,35267,2132000,4415165
1121,2011,TOLEDO,554678,2379230,213957,193088,0,3340953
1122,2011,BARCELONA,120113,4776812,153590,12125,0,5062640
1123,2011,GIRONA,304503,224450,1180,24742,0,554875
1124,2011,LLEIDA,3497644,437660,375900,91030,0,4402234
1125,2011,TARRAGONA,664784,5981410,1217850,48459,6010840,13923343
1126,2011,CEUTA,0,194720,0,0,0,194720
1127,2011,BADAJOZ,387028,21254,0,20523,0,428805
1128,2011,CACERES,3951408,0,0,247155,3914000,8112563
1129,2011,LA CORUÑA,813065,8474938,3092020,3507,0,12383530
1130,2011,LUGO,1072869,62500,3014600,5039,0,4155008
1131,2011,ORENSE,4233696,66456,681860,2667,0,4984679
1132,2011,PONTEVEDRA,409855,138798,1092862,4983,0,1646498
1133,2011,LA RIOJA,95523,3103070,743528,93059,0,4035180
1134,2011,MADRID,658447,557558,0,60865,0,1276870
1135,2011,MELILLA,0,168400,0,220,0,168620
1136,2011,MURCIA,79885,8707385,365925,469052,0,9622247
1137,2011,NAVARRA,344231,2754012,1922857,208384,0,5229484
1138,2011,ALAVA,43348,70504,182930,3025,0,299807
1139,2011,GUIPUZCOA,45838,773268,76000,6927,0,902033
1140,2011,VIZCAYA,184454,6505715,187250,6292,0,6883711
1141,2011,ALICANTE,2326,57406,0,46299,0,106031
1142,2011,CASTELLON,98900,3997870,1549850,55410,0,5702030
1143,2011,VALENCIA,2413024,2844718,917180,156986,2184040,8515948
